1111321111
0000000000
0011001100
0111001110
0000000000
0011111100