1111111111
1311111131
1121111211
1111111111
1001111001