1111331111
1111221111
1110000111
1111111111
1111111111